////////////////////////////////
/............................../
/.#...#......#......#..#..#..#./
/...#....#.#......#............/
/............#..#...#..#..#..#./
/.#....##....................../
/.........#..#..#..#..#..#..#../
/......#.....................#./
/.#......#...................../
/....#.....#..#..#..#..#..#..#./
/.#.......#........#.........#./
/......#....#..#.....#...#...../
/....#...#..#....#..........#../
/........#....#....#...#...#.../
/.#...#....#....#...#....#...#./
/....#...#....#......#..#.#..#./
/.........#.......#...#......../
/.#....#.....#..........#..#.../
/..........#...#..#...#...#..../
/..#...#............#...#...#../
/.#........#..#...#...#...#..#./
/....#...#......#...#.......#../
/............#..........#....../
/.#....#..#.....#...#........../
/...#.....#.......#........#.#./
/.#....#.......#.....#...#...#./
/.....#..#........#....#......./
/...........#..#.............#./
/.#..#...........#.......#...../
/.#...#...@...#....#...#.....#./
/............................../
////////////////////////////////